##########
#        #
#  ##    #
#   #    #
##########
